adama	adam
adamda	adam
adamdan	adam
adamlar	adam
adamları	adam
adamı	adam
adamım	adam
adamımız	adam
adamın	adam
alacak	al
alacaklar	al
alacaksın	al
alacaksınız	al
alacağım	al
alacağız	al
alar	al
alarım	al
aldi	al
aldik	al
aldim	al
aldin	al
aldı	al
aldık	al
aldılar	al
aldım	al
aldın	al
aldınız	al
alecek	al
aleceğim	al
alir	al
alirim	al
aliyor	al
aliyorsun	al
aliyorum	al
aliyoruz	al
almak	al
almek	al
alıyor	al
alıyorlar	al
alıyorsun	al
alıyorsunuz	al
alıyorum	al
alıyoruz	al
anaa	ana
anada	ana
anadan	ana
analar	ana
anaları	ana
anaı	ana
anaım	ana
anaımız	ana
anaın	ana
anlaar	anla
anlaarım	anla
anladi	anla
anladik	anla
anladim	anla
anladin	anla
anlaecek	anla
anlaeceğim	anla
anlair	anla
anlairim	anla
anlaiyor	anla
anlaiyorsun	anla
anlaiyorum	anla
anlaiyoruz	anla
anlamak	anla
anlamek	anla
arabaa	araba
arabada	araba
arabadan	araba
arabalar	araba
arabaları	araba
arabaı	araba
arabaım	araba
arabaımız	araba
arabaın	araba
arkadaşa	arkadaş
arkadaşda	arkadaş
arkadaşdan	arkadaş
arkadaşlar	arkadaş
arkadaşları	arkadaş
arkadaşı	arkadaş
arkadaşım	arkadaş
arkadaşımız	arkadaş
arkadaşın	arkadaş
aya	ay
ayda	ay
aydan	ay
aylar	ay
ayları	ay
ayı	ay
ayım	ay
ayımız	ay
ayın	ay
ağlaar	ağla
ağlaarım	ağla
ağladi	ağla
ağladik	ağla
ağladim	ağla
ağladin	ağla
ağlaecek	ağla
ağlaeceğim	ağla
ağlair	ağla
ağlairim	ağla
ağlaiyor	ağla
ağlaiyorsun	ağla
ağlaiyorum	ağla
ağlaiyoruz	ağla
ağlamak	ağla
ağlamek	ağla
babaa	baba
babada	baba
babadan	baba
babalar	baba
babaları	baba
babaı	baba
babaım	baba
babaımız	baba
babaın	baba
bakar	bak
bakarım	bak
bakdi	bak
bakdik	bak
bakdim	bak
bakdin	bak
bakecek	bak
bakeceğim	bak
bakir	bak
bakirim	bak
bakiyor	bak
bakiyorsun	bak
bakiyorum	bak
bakiyoruz	bak
bakmak	bak
bakmek	bak
bana	ben
başkana	başkan
başkanda	başkan
başkandan	başkan
başkanlar	başkan
başkanları	başkan
başkanı	başkan
başkanım	başkan
başkanımız	başkan
başkanın	başkan
başlaar	başla
başlaarım	başla
başladi	başla
başladik	başla
başladim	başla
başladin	başla
başlaecek	başla
başlaeceğim	başla
başlair	başla
başlairim	başla
başlaiyor	başla
başlaiyorsun	başla
başlaiyorum	başla
başlaiyoruz	başla
başlamak	başla
başlamek	başla
bende	ben
benden	ben
beni	ben
benim	ben
benimle	ben
bilar	bil
bilarım	bil
bildi	bil
bildik	bil
bildiler	bil
bildim	bil
bildin	bil
bildiniz	bil
bilecek	bil
bilecekler	bil
bileceksin	bil
bileceksiniz	bil
bileceğim	bil
bileceğiz	bil
bilir	bil
bilirim	bil
biliyor	bil
biliyorlar	bil
biliyorsun	bil
biliyorsunuz	bil
biliyorum	bil
biliyoruz	bil
bilmak	bil
bilmek	bil
bitirar	bitir
bitirarım	bitir
bitirdi	bitir
bitirdik	bitir
bitirdim	bitir
bitirdin	bitir
bitirecek	bitir
bitireceğim	bitir
bitirir	bitir
bitiririm	bitir
bitiriyor	bitir
bitiriyorsun	bitir
bitiriyorum	bitir
bitiriyoruz	bitir
bitirmak	bitir
bitirmek	bitir
bizde	biz
bizden	biz
bize	biz
bizi	biz
bizim	biz
bizimle	biz
bular	bul
bularım	bul
buldi	bul
buldik	bul
buldim	bul
buldin	bul
bulecek	bul
buleceğim	bul
bulir	bul
bulirim	bul
buliyor	bul
buliyorsun	bul
buliyorum	bul
buliyoruz	bul
bulmak	bul
bulmek	bul
bunlar	bu
bunlara	bu
bunlardan	bu
bunları	bu
bunların	bu
bölgede	bölge
bölgeden	bölge
bölgee	bölge
bölgei	bölge
bölgeim	bölge
bölgeimiz	bölge
bölgein	bölge
bölgeler	bölge
bölgeleri	bölge
büyükler	büyük
büyükleri	büyük
büyüğe	büyük
büyüğü	büyük
büyüğün	büyük
dear	de
dearım	de
dedi	de
dedik	de
dedim	de
dedin	de
deecek	de
deeceğim	de
deir	de
deirim	de
deiyor	de
deiyorsun	de
deiyorum	de
deiyoruz	de
demak	de
demek	de
dilde	dil
dilden	dil
dile	dil
dili	dil
dilim	dil
dilimiz	dil
dilin	dil
diller	dil
dilleri	dil
dinlear	dinle
dinlearım	dinle
dinledi	dinle
dinledik	dinle
dinledim	dinle
dinledin	dinle
dinleecek	dinle
dinleeceğim	dinle
dinleir	dinle
dinleirim	dinle
dinleiyor	dinle
dinleiyorsun	dinle
dinleiyorum	dinle
dinleiyoruz	dinle
dinlemak	dinle
dinlemek	dinle
dünyaa	dünya
dünyada	dünya
dünyadan	dünya
dünyalar	dünya
dünyaları	dünya
dünyanın	dünya
dünyaya	dünya
dünyayı	dünya
dünyaı	dünya
dünyaım	dünya
dünyaımız	dünya
dünyaın	dünya
düşünar	düşün
düşünarım	düşün
düşüncede	düşünce
düşünceden	düşünce
düşüncee	düşünce
düşüncei	düşünce
düşünceim	düşünce
düşünceimiz	düşünce
düşüncein	düşünce
düşünceler	düşünce
düşünceleri	düşünce
düşündi	düşün
düşündik	düşün
düşündim	düşün
düşündin	düşün
düşünecek	düşün
düşüneceğim	düşün
düşünir	düşün
düşünirim	düşün
düşüniyor	düşün
düşüniyorsun	düşün
düşüniyorum	düşün
düşüniyoruz	düşün
düşünmak	düşün
düşünmek	düşün
elde	el
elden	el
ele	el
eli	el
elim	el
elimiz	el
elin	el
eller	el
elleri	el
erkekler	erkek
erkekleri	erkek
erkekte	erkek
erkekten	erkek
erkeğe	erkek
erkeği	erkek
erkeğin	erkek
eskileri	eski
eskilerin	eski
eskinin	eski
eskiye	eski
eskiyi	eski
etar	et
etarım	et
etdi	et
etdik	et
etdim	et
etdin	et
etecek	et
eteceğim	et
etir	et
etirim	et
etiyor	et
etiyorsun	et
etiyorum	et
etiyoruz	et
etmak	et
etmek	et
evde	ev
evden	ev
eve	ev
evi	ev
evim	ev
evimiz	ev
evin	ev
evler	ev
evleri	ev
fikirde	fikir
fikirden	fikir
fikire	fikir
fikiri	fikir
fikirim	fikir
fikirimiz	fikir
fikirin	fikir
fikirler	fikir
fikirleri	fikir
gecede	gece
geceden	gece
gecee	gece
gecei	gece
geceim	gece
geceimiz	gece
gecein	gece
geceler	gece
geceleri	gece
gelar	gel
gelarım	gel
geldi	gel
geldik	gel
geldiler	gel
geldim	gel
geldin	gel
geldiniz	gel
gelecek	gel
gelecekler	gel
geleceksin	gel
geleceksiniz	gel
geleceğim	gel
geleceğiz	gel
gelir	gel
gelirim	gel
geliyor	gel
geliyorlar	gel
geliyorsun	gel
geliyorsunuz	gel
geliyorum	gel
geliyoruz	gel
gelmak	gel
gelmek	gel
gidecek	git
gidecekler	git
gideceksin	git
gideceksiniz	git
gideceğim	git
gideceğiz	git
gidiyor	git
gidiyorlar	git
gidiyorsun	git
gidiyorsunuz	git
gidiyorum	git
gidiyoruz	git
girişimar	girişim
girişimarım	girişim
girişimdi	girişim
girişimdik	girişim
girişimdim	girişim
girişimdin	girişim
girişimecek	girişim
girişimeceğim	girişim
girişimir	girişim
girişimirim	girişim
girişimiyor	girişim
girişimiyorsun	girişim
girişimiyorum	girişim
girişimiyoruz	girişim
girişimmak	girişim
girişimmek	girişim
gitti	git
gittik	git
gittiler	git
gittim	git
gittin	git
gittiniz	git
gönülde	gönül
gönülden	gönül
gönüle	gönül
gönüli	gönül
gönülim	gönül
gönülimiz	gönül
gönülin	gönül
gönüller	gönül
gönülleri	gönül
görar	gör
görarım	gör
gördi	gör
gördik	gör
gördim	gör
gördin	gör
gördü	gör
gördük	gör
gördüler	gör
gördüm	gör
gördün	gör
gördünüz	gör
görecek	gör
görecekler	gör
göreceksin	gör
göreceksiniz	gör
göreceğim	gör
göreceğiz	gör
görir	gör
göririm	gör
göriyor	gör
göriyorsun	gör
göriyorum	gör
göriyoruz	gör
görmak	gör
görmek	gör
görüyor	gör
görüyorlar	gör
görüyorsun	gör
görüyorsunuz	gör
görüyorum	gör
görüyoruz	gör
gözde	göz
gözden	göz
göze	göz
gözi	göz
gözim	göz
gözimiz	göz
gözin	göz
gözler	göz
gözleri	göz
gülar	gül
gülarım	gül
güldi	gül
güldik	gül
güldim	gül
güldin	gül
gülecek	gül
güleceğim	gül
gülir	gül
gülirim	gül
güliyor	gül
güliyorsun	gül
güliyorum	gül
güliyoruz	gül
gülmak	gül
gülmek	gül
güna	gün
günda	gün
gündan	gün
günde	gün
günden	gün
güne	gün
güni	gün
günim	gün
günimiz	gün
günin	gün
günlar	gün
günları	gün
günler	gün
günleri	gün
günü	gün
günün	gün
günı	gün
günım	gün
günımız	gün
günın	gün
güzele	güzel
güzeli	güzel
güzelin	güzel
güzeller	güzel
güzelleri	güzel
hükümetde	hükümet
hükümetden	hükümet
hükümete	hükümet
hükümeti	hükümet
hükümetim	hükümet
hükümetimiz	hükümet
hükümetin	hükümet
hükümetler	hükümet
hükümetleri	hükümet
insana	insan
insanda	insan
insandan	insan
insanlar	insan
insanları	insan
insanı	insan
insanın	insan
istear	iste
istearım	iste
istedi	iste
istedik	iste
istediler	iste
istedim	iste
istedin	iste
istediniz	iste
isteecek	iste
isteeceğim	iste
isteir	iste
isteirim	iste
isteiyor	iste
isteiyorsun	iste
isteiyorum	iste
isteiyoruz	iste
istemak	iste
istemek	iste
isteyecek	iste
isteyecekler	iste
isteyeceksin	iste
isteyeceksiniz	iste
isteyeceğim	iste
isteyeceğiz	iste
istiyor	iste
istiyorlar	iste
istiyorsun	iste
istiyorsunuz	iste
istiyorum	iste
istiyoruz	iste
iyiler	iyi
iyileri	iyi
iyinin	iyi
iyiye	iyi
iyiyi	iyi
içar	iç
içarım	iç
içdi	iç
içdik	iç
içdim	iç
içdin	iç
içecek	iç
içeceğim	iç
içir	iç
içirim	iç
içiyor	iç
içiyorsun	iç
içiyorum	iç
içiyoruz	iç
içmak	iç
içmek	iç
işde	iş
işden	iş
işe	iş
işi	iş
işim	iş
işimiz	iş
işin	iş
işler	iş
işleri	iş
kadına	kadın
kadında	kadın
kadından	kadın
kadınlar	kadın
kadınları	kadın
kadını	kadın
kadınım	kadın
kadınımız	kadın
kadının	kadın
kalkar	kalk
kalkarım	kalk
kalkdi	kalk
kalkdik	kalk
kalkdim	kalk
kalkdin	kalk
kalkecek	kalk
kalkeceğim	kalk
kalkir	kalk
kalkirim	kalk
kalkiyor	kalk
kalkiyorsun	kalk
kalkiyorum	kalk
kalkiyoruz	kalk
kalkmak	kalk
kalkmek	kalk
kapıa	kapı
kapıda	kapı
kapıdan	kapı
kapılar	kapı
kapıları	kapı
kapıı	kapı
kapıım	kapı
kapıımız	kapı
kapıın	kapı
kardeşa	kardeş
kardeşda	kardeş
kardeşdan	kardeş
kardeşlar	kardeş
kardeşları	kardeş
kardeşı	kardeş
kardeşım	kardeş
kardeşımız	kardeş
kardeşın	kardeş
kitaba	kitap
kitabı	kitap
kitabım	kitap
kitabımız	kitap
kitabın	kitap
kitaplar	kitap
kitapları	kitap
kitapta	kitap
kitaptan	kitap
kişide	kişi
kişiden	kişi
kişie	kişi
kişii	kişi
kişiim	kişi
kişiimiz	kişi
kişiin	kişi
kişiler	kişi
kişileri	kişi
konua	konu
konuda	konu
konudan	konu
konular	konu
konuları	konu
konuı	konu
konuım	konu
konuımız	konu
konuın	konu
konuşar	konuş
konuşarım	konuş
konuşdi	konuş
konuşdik	konuş
konuşdim	konuş
konuşdin	konuş
konuşecek	konuş
konuşeceğim	konuş
konuşir	konuş
konuşirim	konuş
konuşiyor	konuş
konuşiyorsun	konuş
konuşiyorum	konuş
konuşiyoruz	konuş
konuşmak	konuş
konuşmek	konuş
koşar	koş
koşarım	koş
koşdi	koş
koşdik	koş
koşdim	koş
koşdin	koş
koşecek	koş
koşeceğim	koş
koşir	koş
koşirim	koş
koşiyor	koş
koşiyorsun	koş
koşiyorum	koş
koşiyoruz	koş
koşmak	koş
koşmek	koş
kötüler	kötü
kötüleri	kötü
kötünün	kötü
kötüye	kötü
kötüyü	kötü
küçükler	küçük
küçükleri	küçük
küçüğe	küçük
küçüğü	küçük
küçüğün	küçük
kıza	kız
kızda	kız
kızdan	kız
kızlar	kız
kızları	kız
kızı	kız
kızım	kız
kızımız	kız
kızın	kız
masaa	masa
masada	masa
masadan	masa
masalar	masa
masaları	masa
masaı	masa
masaım	masa
masaımız	masa
masaın	masa
nefretar	nefret
nefretarım	nefret
nefretdi	nefret
nefretdik	nefret
nefretdim	nefret
nefretdin	nefret
nefretecek	nefret
nefreteceğim	nefret
nefretir	nefret
nefretirim	nefret
nefretiyor	nefret
nefretiyorsun	nefret
nefretiyorum	nefret
nefretiyoruz	nefret
nefretmak	nefret
nefretmek	nefret
odaa	oda
odada	oda
odadan	oda
odalar	oda
odaları	oda
odaı	oda
odaım	oda
odaımız	oda
odaın	oda
okuar	oku
okuarım	oku
okudi	oku
okudik	oku
okudim	oku
okudin	oku
okudu	oku
okuduk	oku
okudular	oku
okudum	oku
okudun	oku
okudunuz	oku
okuecek	oku
okueceğim	oku
okuir	oku
okuirim	oku
okuiyor	oku
okuiyorsun	oku
okuiyorum	oku
okuiyoruz	oku
okula	okul
okulda	okul
okuldan	okul
okullar	okul
okulları	okul
okullар	okul
okulu	okul
okulun	okul
okulı	okul
okulım	okul
okulımız	okul
okulın	okul
okumak	oku
okumek	oku
okuyacak	oku
okuyacaklar	oku
okuyacaksın	oku
okuyacaksınız	oku
okuyacağım	oku
okuyacağız	oku
okuyor	oku
okuyorlar	oku
okuyorsun	oku
okuyorsunuz	oku
okuyorum	oku
okuyoruz	oku
olacak	ol
olacaklar	ol
olacaksın	ol
olacaksınız	ol
olacağım	ol
olacağız	ol
olar	ol
olarım	ol
oldi	ol
oldik	ol
oldim	ol
oldin	ol
oldu	ol
olduk	ol
oldular	ol
oldum	ol
oldun	ol
oldunuz	ol
olecek	ol
oleceğim	ol
olir	ol
olirim	ol
oliyor	ol
oliyorsun	ol
oliyorum	ol
oliyoruz	ol
olmak	ol
olmek	ol
oluyor	ol
oluyorlar	ol
oluyorsun	ol
oluyorsunuz	ol
oluyorum	ol
oluyoruz	ol
ona	o
onda	o
ondan	o
onlara	onlar
onlarda	onlar
onlardan	onlar
onlarla	onlar
onları	onlar
onların	onlar
onu	o
onun	o
onunla	o
oturar	otur
oturarım	otur
oturdi	otur
oturdik	otur
oturdim	otur
oturdin	otur
oturecek	otur
otureceğim	otur
oturir	otur
oturirim	otur
oturiyor	otur
oturiyorsun	otur
oturiyorum	otur
oturiyoruz	otur
oturmak	otur
oturmek	otur
oynaar	oyna
oynaarım	oyna
oynadi	oyna
oynadik	oyna
oynadim	oyna
oynadin	oyna
oynaecek	oyna
oynaeceğim	oyna
oynair	oyna
oynairim	oyna
oynaiyor	oyna
oynaiyorsun	oyna
oynaiyorum	oyna
oynaiyoruz	oyna
oynamak	oyna
oynamek	oyna
oğlana	oğlan
oğlanda	oğlan
oğlandan	oğlan
oğlanlar	oğlan
oğlanları	oğlan
oğlanı	oğlan
oğlanım	oğlan
oğlanımız	oğlan
oğlanın	oğlan
paraa	para
parada	para
paradan	para
paralar	para
paraları	para
paraı	para
paraım	para
paraımız	para
paraın	para
projea	proje
projeda	proje
projedan	proje
projelar	proje
projeları	proje
projeı	proje
projeım	proje
projeımız	proje
projeın	proje
saata	saat
saatda	saat
saatdan	saat
saate	saat
saati	saat
saatin	saat
saatlar	saat
saatları	saat
saatler	saat
saatleri	saat
saattan	saat
saatte	saat
saatı	saat
saatım	saat
saatımız	saat
saatın	saat
sana	sen
sende	sen
senden	sen
seni	sen
senin	sen
seninle	sen
sevar	sev
sevarım	sev
sevdi	sev
sevdik	sev
sevdim	sev
sevdin	sev
sevecek	sev
seveceğim	sev
sevir	sev
sevirim	sev
seviyor	sev
seviyorsun	sev
seviyorum	sev
seviyoruz	sev
sevmak	sev
sevmek	sev
sizde	siz
sizden	siz
size	siz
sizi	siz
sizin	siz
sizinle	siz
soruna	sorun
sorunda	sorun
sorundan	sorun
sorunlar	sorun
sorunları	sorun
sorunı	sorun
sorunım	sorun
sorunımız	sorun
sorunın	sorun
söylear	söyle
söylearım	söyle
söyledi	söyle
söyledik	söyle
söylediler	söyle
söyledim	söyle
söyledin	söyle
söylediniz	söyle
söyleecek	söyle
söyleeceğim	söyle
söyleir	söyle
söyleirim	söyle
söyleiyor	söyle
söyleiyorsun	söyle
söyleiyorum	söyle
söyleiyoruz	söyle
söylemak	söyle
söylemek	söyle
söyleyecek	söyle
söyleyecekler	söyle
söyleyeceksin	söyle
söyleyeceksiniz	söyle
söyleyeceğim	söyle
söyleyeceğiz	söyle
söylüyor	söyle
söylüyorlar	söyle
söylüyorsun	söyle
söylüyorsunuz	söyle
söylüyorum	söyle
söylüyoruz	söyle
sözde	söz
sözden	söz
söze	söz
sözi	söz
sözim	söz
sözimiz	söz
sözin	söz
sözler	söz
sözleri	söz
sınıfa	sınıf
sınıfda	sınıf
sınıfdan	sınıf
sınıflar	sınıf
sınıfları	sınıf
sınıfı	sınıf
sınıfım	sınıf
sınıfımız	sınıf
sınıfın	sınıf
topluma	toplum
toplumda	toplum
toplumdan	toplum
toplumlar	toplum
toplumları	toplum
toplumı	toplum
toplumım	toplum
toplumımız	toplum
toplumın	toplum
uyuar	uyu
uyuarım	uyu
uyudi	uyu
uyudik	uyu
uyudim	uyu
uyudin	uyu
uyuecek	uyu
uyueceğim	uyu
uyuir	uyu
uyuirim	uyu
uyuiyor	uyu
uyuiyorsun	uyu
uyuiyorum	uyu
uyuiyoruz	uyu
uyumak	uyu
uyumek	uyu
verar	ver
verarım	ver
verdi	ver
verdik	ver
verdiler	ver
verdim	ver
verdin	ver
verdiniz	ver
verecek	ver
verecekler	ver
vereceksin	ver
vereceksiniz	ver
vereceğim	ver
vereceğiz	ver
verir	ver
veririm	ver
veriyor	ver
veriyorlar	ver
veriyorsun	ver
veriyorsunuz	ver
veriyorum	ver
veriyoruz	ver
vermak	ver
vermek	ver
yapacak	yap
yapacaklar	yap
yapacaksın	yap
yapacaksınız	yap
yapacağım	yap
yapacağız	yap
yapar	yap
yaparım	yap
yapdi	yap
yapdik	yap
yapdim	yap
yapdin	yap
yapecek	yap
yapeceğim	yap
yapir	yap
yapirim	yap
yapiyor	yap
yapiyorsun	yap
yapiyorum	yap
yapiyoruz	yap
yapmak	yap
yapmek	yap
yaptı	yap
yaptık	yap
yaptılar	yap
yaptım	yap
yaptın	yap
yaptınız	yap
yapıyor	yap
yapıyorlar	yap
yapıyorsun	yap
yapıyorsunuz	yap
yapıyorum	yap
yapıyoruz	yap
yazacak	yaz
yazacaklar	yaz
yazacaksın	yaz
yazacaksınız	yaz
yazacağım	yaz
yazacağız	yaz
yazar	yaz
yazarım	yaz
yazdi	yaz
yazdik	yaz
yazdim	yaz
yazdin	yaz
yazdı	yaz
yazdık	yaz
yazdılar	yaz
yazdım	yaz
yazdın	yaz
yazdınız	yaz
yazecek	yaz
yazeceğim	yaz
yazir	yaz
yazirim	yaz
yaziyor	yaz
yaziyorsun	yaz
yaziyorum	yaz
yaziyoruz	yaz
yazmak	yaz
yazmek	yaz
yazıyor	yaz
yazıyorlar	yaz
yazıyorsun	yaz
yazıyorsunuz	yaz
yazıyorum	yaz
yazıyoruz	yaz
year	ye
yearım	ye
yedi	ye
yedik	ye
yedim	ye
yedin	ye
yeecek	ye
yeeceğim	ye
yeir	ye
yeirim	ye
yeiyor	ye
yeiyorsun	ye
yeiyorum	ye
yeiyoruz	ye
yemak	ye
yemek	ye
yeniler	yeni
yenileri	yeni
yeninin	yeni
yeniye	yeni
yeniyi	yeni
yerde	yer
yerden	yer
yere	yer
yeri	yer
yerim	yer
yerimiz	yer
yerin	yer
yerler	yer
yerleri	yer
yola	yol
yolda	yol
yoldan	yol
yollar	yol
yolları	yol
yolı	yol
yolım	yol
yolımız	yol
yolın	yol
yürüar	yürü
yürüarım	yürü
yürüdi	yürü
yürüdik	yürü
yürüdim	yürü
yürüdin	yürü
yürüecek	yürü
yürüeceğim	yürü
yürüir	yürü
yürüirim	yürü
yürüiyor	yürü
yürüiyorsun	yürü
yürüiyorum	yürü
yürüiyoruz	yürü
yürümak	yürü
yürümek	yürü
yüzde	yüz
yüzden	yüz
yüze	yüz
yüzi	yüz
yüzim	yüz
yüzimiz	yüz
yüzin	yüz
yüzler	yüz
yüzleri	yüz
yıla	yıl
yılda	yıl
yıldan	yıl
yılde	yıl
yılden	yıl
yıle	yıl
yıli	yıl
yılim	yıl
yılimiz	yıl
yılin	yıl
yıllar	yıl
yılları	yıl
yıller	yıl
yılleri	yıl
yılı	yıl
yılın	yıl
çalışar	çalış
çalışarım	çalış
çalışdi	çalış
çalışdik	çalış
çalışdim	çalış
çalışdin	çalış
çalışecek	çalış
çalışeceğim	çalış
çalışir	çalış
çalışirim	çalış
çalışiyor	çalış
çalışiyorsun	çalış
çalışiyorum	çalış
çalışiyoruz	çalış
çalışmak	çalış
çalışmek	çalış
çocuka	çocuk
çocukda	çocuk
çocukdan	çocuk
çocuklar	çocuk
çocukları	çocuk
çocukta	çocuk
çocuktan	çocuk
çocukı	çocuk
çocukım	çocuk
çocukımız	çocuk
çocukın	çocuk
çocuğa	çocuk
çocuğu	çocuk
çocuğun	çocuk
çözüma	çözüm
çözümda	çözüm
çözümdan	çözüm
çözümlar	çözüm
çözümları	çözüm
çözümı	çözüm
çözümım	çözüm
çözümımız	çözüm
çözümın	çözüm
çıkar	çık
çıkarım	çık
çıkdi	çık
çıkdik	çık
çıkdim	çık
çıkdin	çık
çıkecek	çık
çıkeceğim	çık
çıkir	çık
çıkirim	çık
çıkiyor	çık
çıkiyorsun	çık
çıkiyorum	çık
çıkiyoruz	çık
çıkmak	çık
çıkmek	çık
öğrenar	öğren
öğrenarım	öğren
öğrencide	öğrenci
öğrenciden	öğrenci
öğrencie	öğrenci
öğrencii	öğrenci
öğrenciim	öğrenci
öğrenciimiz	öğrenci
öğrenciin	öğrenci
öğrenciler	öğrenci
öğrencileri	öğrenci
öğrendi	öğren
öğrendik	öğren
öğrendim	öğren
öğrendin	öğren
öğrenecek	öğren
öğreneceğim	öğren
öğrenir	öğren
öğrenirim	öğren
öğreniyor	öğren
öğreniyorsun	öğren
öğreniyorum	öğren
öğreniyoruz	öğren
öğrenmak	öğren
öğrenmek	öğren
öğretar	öğret
öğretarım	öğret
öğretdi	öğret
öğretdik	öğret
öğretdim	öğret
öğretdin	öğret
öğretecek	öğret
öğreteceğim	öğret
öğretir	öğret
öğretirim	öğret
öğretiyor	öğret
öğretiyorsun	öğret
öğretiyorum	öğret
öğretiyoruz	öğret
öğretmak	öğret
öğretmek	öğret
ülkede	ülke
ülkeden	ülke
ülkee	ülke
ülkei	ülke
ülkeim	ülke
ülkeimiz	ülke
ülkein	ülke
ülkeler	ülke
ülkeleri	ülke
ülkenin	ülke
ülkeye	ülke
ülkeyi	ülke
şehirde	şehir
şehirden	şehir
şehire	şehir
şehiri	şehir
şehirim	şehir
şehirimiz	şehir
şehirin	şehir
şehirler	şehir
şehirleri	şehir
şehre	şehir
şehri	şehir
şehrin	şehir
şeyde	şey
şeyden	şey
şeye	şey
şeyi	şey
şeyim	şey
şeyimiz	şey
şeyin	şey
şeyler	şey
şeyleri	şey
şirketa	şirket
şirketda	şirket
şirketdan	şirket
şirketlar	şirket
şirketları	şirket
şirketı	şirket
şirketım	şirket
şirketımız	şirket
şirketın	şirket
şunlar	şu
şunlara	şu
şunlardan	şu
şunları	şu
şunların	şu
